111111
1P11C1
101101
101101
101101
100001
111011
111011
111E11
11111
111111
111111