111111
100001
111101
101PC1
111E11
111111
111111