1111111111111
1P11C11E00001
1011011000C01
1011011111001
1011011111001
1000011000001
1110011001111
1110011001111
111C0000000C1
111C0110000C1
1111111111111